 ___________________________________________
|                    |                      |
|                    |                      |
|                    |                      |
|                    |                      |
|                    |                      |
|                    |                      |
|--------------------+----------------------|
|                    |                      |
|                    |                      |
|                    |                      |
|                    |                      |
|              X     |                      |
|                    |                      |
 --------------------------------------------