 ___________________________________________
|                    |                      |
|                    |                      |
|                    |                      |
|                    |                      |
|                    |                      |
|                    |                      |
|--------------------+----------------------|
|                    |                      |
|                    |                      |
|                    |                      |
|                    |                      |
|                    |    X                 |
|                    |                      |
 --------------------------------------------