 ___________________________________________
|                    |                      |
|                    |                      |
|                    |                      |
|                    |                      |
|                    |                      |
|                    |                      |
|--------------------+----------------------|
|                    |                      |
|                    |                X     |
|                    |                      |
|                    |                      |
|                    |                      |
|                    |                      |
 --------------------------------------------