 ___________________________________________
|                    |                      |
|    X               |                      |
|                    |                      |
|                    |                      |
|                    |                      |
|                    |                      |
|--------------------+----------------------|
|                    |                      |
|                    |                      |
|                    |                      |
|                    |                      |
|                    |                      |
|                    |                      |
 --------------------------------------------